The door opens.~~~~~~~~~~~~~~~~~~~~~~~~~~~~~~~~~~~~~~~~~~~~~~~~~
~~~~~~~~~~~~~~~~~~~~~~~~~~~~~~~~~~~~~~~~~~~~~~~~~~~~~~~~~~~~~~~~
~~~~~~~~~~~~~~~~~~~~~~~~~~~~~~~~~~~~~~~~~~~~~~~~~~~~~~~~~~~~~~~~
~~~~~~~~~~~~~~~~~~~~~~~~~~~~~~~~~~~~~~~~~~~~~~~~~~~~~~~~~~~~~~~~
~~~~~~~~~~~~~------#---------------------------~~~~~~~~~~~~~~~~~
~~~~~~~~~~~~~|...............|%%%%%%%%%%%%%%%%|~~~~~~~~~~~~~~~~~
~~~~~~~~~~~~~|...............|%%%%%%%%%%%%%%%%|~~~~~~~~~~~~~~~~~
~~~~~~~~~~~~~|...............|%%%%%%%%%%%%%%%%|~~~~~~~~~~~~~~~~~
~~~~~~~~~~~~~|...............|%%%%%%%%%%%%%%%%|~~~~~~~~~~~~~~~~~
~~~~~~~~~~~~~|-----|----------%%%%%%%%%%%%%%%%|~~~~~~~~~~~~~~~~~
~~~~~~~~~~~~~|.....r.......*^%%%%%%%%%%%%%%%%%|~~~~~~~~~~~~~~~~~
~~~~~~~~~~~~~|----------------%%%%%%%%%%%%%%%%|~~~~~~~~~~~~~~~~~
~~~~~~~~~~~~~|..............*|%%%%%%%%%%%%%%%%|~~~~~~~~~~~~~~~~~
~~~~~~~~~~~~~|...............|%%%%%%%%%%%%%%%%|~~~~~~~~~~~~~~~~~
~~~~~~~~~~~~~|...............|%%%%%%%%%%%%%%%%|~~~~~~~~~~~~~~~~~
~~~~~~~~~~~~~|...............|%%%%%%%%%%%%%%%%|~~~~~~~~~~~~~~~~~
~~~~~~~~~~~~~|...............|%%%%%%%%%%%%%%%%|~~~~~~~~~~~~~~~~~
~~~~~~~~~~~~~----------------------------------~~~~~~~~~~~~~~~~~
~~~~~~~~~~~~~~~~~~~~~~~~~~~~~~~~~~~~~~~~~~~~~~~~~~~~~~~~~~~~~~~~
~~~~~~~~~~~~~~~~~~~~~~~~~~~~~~~~~~~~~~~~~~~~~~~~~~~~~~~~~~~~~~~~
~~~~~~~~~~~~~~~~~~~~~~~~~~~~~~~~~~~~~~~~~~~~~~~~~~~~~~~~~~~~~~~~
~~~~~~~~~~~~~~~~~~~~~~~~~~~~~~~~~~~~~~~~~~~~~~~~~~~~~~~~~~~~~~~~
~~~~~~~~~~~~~~~~~~~~~~~~~~~~~~~~~~~~~~~~~~~~~~~~~~~~~~~~~~~~~~~~
~~~~~~~~~~~~~~~~~~~~~~~~~~~~~~~~~~~~~~~~~~~~~~~~~~~~~~~~~~~~~~~~
