~~~~~~~~~~~~~~~~~~~~~~~~~~~~~~~~~~~~~~~~~~~~~~~~~~~~~~~~~~~~~~~~
~~~~~~~~~~~~~~~~~~~~~~~~~~~~~~~~~~~~~~~~~~~~~~~~~~~~~~~~~~~~~~~~
~~~~~~~~~~~~~~~~~~~~~~~~~~~~~~~~~~~~~~~~~~~~~~~~~~~~~~~~~~~~~~~~
~~~~~~~~~~~~~~~~~~~~~~~~~~~~~~~~~~~~~~~~~~~~~~~~~~~~~~~~~~~~~~~~
~~~~~~~~~~~~~------#---------------------------~~~~~~~~~~~~~~~~~
~~~~~~~~~~~~~|...............|%%%%%%%%%%%%%%%%|~~~~~~~~~~~~~~~~~
~~~~~~~~~~~~~|...............|%%%%%%%%%%%%%%%%|~~~~~~~~~~~~~~~~~
~~~~~~~~~~~~~|...............|%%%%%%%%%%%%%%%%|~~~~~~~~~~~~~~~~~
~~~~~~~~~~~~~|...............|%%%%%%%%%%%%%%%%|~~~~~~~~~~~~~~~~~
~~~~~~~~~~~~~|-----r----------%%%%%%%%%%%%%%%%|~~~~~~~~~~~~~~~~~
~~~~~~~~~~~~~|.............*^%%%%%%%%%%%%%%%%%|~~~~~~~~~~~~~~~~~
~~~~~~~~~~~~~|----------------%%%%%%%%%%%%%%%%|~~~~~~~~~~~~~~~~~
~~~~~~~~~~~~~|..............*|%%%%%%%%%%%%%%%%|~~~~~~~~~~~~~~~~~
~~~~~~~~~~~~~|...............|%%%%%%%%%%%%%%%%|~~~~~~~~~~~~~~~~~
~~~~~~~~~~~~~|...............|%%%%%%%%%%%%%%%%|~~~~~~~~~~~~~~~~~
~~~~~~~~~~~~~|...............|%%%%%%%%%%%%%%%%|~~~~~~~~~~~~~~~~~
~~~~~~~~~~~~~|...............|%%%%%%%%%%%%%%%%|~~~~~~~~~~~~~~~~~
~~~~~~~~~~~~~----------------------------------~~~~~~~~~~~~~~~~~
~~~~~~~~~~~~~~~~~~~~~~~~~~~~~~~~~~~~~~~~~~~~~~~~~~~~~~~~~~~~~~~~
~~~~~~~~~~~~~~~~~~~~~~~~~~~~~~~~~~~~~~~~~~~~~~~~~~~~~~~~~~~~~~~~
~~~~~~~~~~~~~~~~~~~~~~~~~~~~~~~~~~~~~~~~~~~~~~~~~~~~~~~~~~~~~~~~
~~~~~~~~~~~~~~~~~~~~~~~~~~~~~~~~~~~~~~~~~~~~~~~~~~~~~~~~~~~~~~~~
~~~~~~~~~~~~~~~~~~~~~~~~~~~~~~~~~~~~~~~~~~~~~~~~~~~~~~~~~~~~~~~~
~~~~~~~~~~~~~~~~~~~~~~~~~~~~~~~~~~~~~~~~~~~~~~~~~~~~~~~~~~~~~~~~
