~.....................................~~~~~~~~~~~~~~~~~~~~~~~~~~
~~~~...............................~~~~~~~~~~~~~~~~~~~~~~~~~~~~~
~~~~~~~.........................~~~~~~~~~~~~~~~~~~~~~~~~~~~~~~~~
~~~~~~~~~~...................~~~~~~~~~~~~~~~~~~~~~~~~~~~~~~~~~~~
~~~~~~~~~~~~~------#---------------------------~~~~~~~~~~~~~~~~~
~~~~~~~~~~~~~|...............|%%%%%%%%%%%%%%%%|~~~~~~~~~~~~~~~~~
~~~~~~~~~~~~~|...............|%%%%%%%%%%%%%%%%|~~~~~~~~~~~~~~~~~
~~~~~~~~~~~~~|...............|%%%%%%%%%%%%%%%%|~~~~~~~~~~~~~~~~~
~~~~~~~~~~~~~|...............|%%%%%%%%%%%%%%%%|~~~~~~~~~~~~~~~~~
~~~~~~~~~~~~~|-----|----------%%%%%%%%%%%%%%%%|~~~~~~~~~~~~~~~~~
~~~~~~~~~~~~~|.............*^%%%%%%%%%%%%%%%%%|~~~~~~~~~~~~~~~~~
~~~~~~~~~~~~~|----------------%%%%%%%%%%%%%%%%|~~~~~~~~~~~~~~~~~
~~~~~~~~~~~~~|..............*|%%%%%%%%%%%%%%%%|~~~~~~~~~~~~~~~~~
~~~~~~~~~~~~~|...............|%%%%%%%%%%%%%%%%|~~~~~~~~~~~~~~~~~
~~~~~~~~~~~~~|...............|%%%%%%%%%%%%%%%%|~~~~~~~~~~~~~~~~~
~~~~~~~~~~~~~|...............|%%%%%%%%%%%%%%%%|~~~~~~~~~~~~~~~~~
~~~~~~~~~~~~~|...............|%%%%%%%%%%%%%%%%|~~~~~~~~~~~~~~~~~
~~~~~~~~~~~~~----------------------------------~~~~~~~~~~~~~~~~~
~~~~~~~~~~~~~~~~~~~~~~~~~~~~~~~~~~~~~~~~~~~~~~~~~~~~~~~~~~~~~~~~
~~~~~~~~~~~~~~~~~~~~~~~~~~~~~~~~~~~~~~~~~~~~~~~~~~~~~~~~~~~~~~~~
~~~~~~~~~~~~~~~~~~~~~~~~~~~~~~~~~~~~~~~~~~~~~~~~~~~~~~~~~~~~~~~~
~~~~~~~~~~~~~~~~~~~~~~~~~~~~~~~~~~~~~~~~~~~~~~~~~~~~~~~~~~~~~~~~
~~~~~~~~~~~~~~~~~~~~~~~~~~~~~~~~~~~~~~~~~~~~~~~~~~~~~~~~~~~~~~~~
~~~~~~~~~~~~~~~~~~~~~~~~~~~~~~~~~~~~~~~~~~~~~~~~~~~~~~~~~~~~~~~~
