You escape.~..........................~~~~~~~~~~~~~~~~~~~~~~~~~~
~~~~...............................~~~~~~~~~~~~~~~~~~~~~~~~~~~~~
~~~~~~~.........................~~~~~~~~~~~~~~~~~~~~~~~~~~~~~~~~
~~~~~~~~~~...................~~~~~~~~~~~~~~~~~~~~~~~~~~~~~~~~~~~
~~~~~~~~~~~~~------|---------------------------~~~~~~~~~~~~~~~~~
~~~~~~~~~~~~~|~~~~~.~~~~~~~~~~~~~~~~~~~~~~~~~~|~~~~~~~~~~~~~~~~~
~~~~~~~~~~~~~|~~~~...~~~~~~~~~~~~~~~~~~~~~~~~~|~~~~~~~~~~~~~~~~~
~~~~~~~~~~~~~|~~~.....~~~~~~~~~~~~~~~~~~~~~~~~|~~~~~~~~~~~~~~~~~
~~~~~~~~~~~~~|~~.......~~~~~~~~~~~~~~~~~~~~~~~|~~~~~~~~~~~~~~~~~
~~~~~~~~~~~~~|~.........~~~~~~~~~~~~~~~~~~~~~~|~~~~~~~~~~~~~~~~~
~~~~~~~~~~~~~|...........~~~~~~~~~~~~~~~~~~~~~|~~~~~~~~~~~~~~~~~
~~~~~~~~~~~~~|............~~~~~~~~~~~~~~~~~~~~|~~~~~~~~~~~~~~~~~
~~~~~~~~~~~~~|.............~~~~~~~~~~~~~~~~~~~|~~~~~~~~~~~~~~~~~
~~~~~~~~~~~~~|..............~~~~~~~~~~~~~~~~~~|~~~~~~~~~~~~~~~~~
~~~~~~~~~~~~~|...............~~~~~~~~~~~~~~~~~|~~~~~~~~~~~~~~~~~
~~~~~~~~~~~~~|................~~~~~~~~~~~~~~~~|~~~~~~~~~~~~~~~~~
~~~~~~~~~~~~~|.................~~~~~~~~~~~~~~~|~~~~~~~~~~~~~~~~~
~~~~~~~~~~~~~----------------------------------~~~~~~~~~~~~~~~~~
~~~~~~~~~~~~~~~~~~~~~~~~~~~~~~~~~~~~~~~~~~~~~~~~~~~~~~~~~~~~~~~~
~~~~~~~~~~~~~~~~~~~~~~~~~~~~~~~~~~~~~~~~~~~~~~~~~~~~~~~~~~~~~~~~
~~~~~~~~~~~~~~~~~~~~~~~~~~~~~~~~~~~~~~~~~~~~~~~~~~~~~~~~~~~~~~~~
~~~~~~~~~~~~~~~~~~~~~~~~~~~~~~~~~~~~~~~~~~~~~~~~~~~~~~~~~~~~~~~~
~~~~~~~~~~~~~~~~~~~~~~~~~~~~~~~~~~~~~~~~~~~~~~~~~~~~~~~~~~~~~~~~
~~~~~~~~~~~~~~~~~~~~~~~~~~~~~~~~~~~~~~~~~~~~~~~~~~~~~~~~~~~~~~~~
